CCCCCCCCCCCCCCC
M##############
00000#000#0000#
#00#0#0#0####0#
#00#000#000000#
#0####0######0#
#0000000000000#
##0####0#####0#
#0000#000#0##0#
####000#000#00#
#00000####0####
#0###0000#000##
#00000#0000#00#
#0#0#0###0#####
#0#0#000#00000G
###############
