###############
M        #    #
#  # # # ## ###
#  # # #      #
# #### ###### #
#             #
## ########## #
#    #   # ## #
####   #   #  #
#  ### ### ####
# ###    #   ##
#     #    #  #
# # # ### ### #
#   #   # #  G
###############
