###############
M        #    #
#  # # # ######
#  # # #      #
# #### #####  #
#             #
## #### ##### #
#    #   # ## #
####   #   #  #
#     #### ####
# ###    #   ##
#     #    #  #
# # # ### ### #
#   #   #    G
###############
